   WE                            assets/grey_stone.xpm
NO      assets/purple_stone.xpm



SO assets/wall_brick.xpm

F      17,    38,     64

EA assets/wood.xpm



C 218, 234, 235


11111
11N11
11111
