   WE                            assets/grey_stone.xpm
NO      assets/purple_stone.xpm



SO assets/wall_brick.xpm

F      28  ,    100,    10

EA assets/wood.xpm



C 252, 186, 3

111111111111111111111111
1001100S0000000000000001
100000011000000000000001
111111111111111111111111