   WE                            subject.pdf 
NO      subject.pdf



SO subject.pdf

F      28  ,    100,    10

EA subject.pdf



C 225,   30,4

111111111111111111111111
1001100N0000000000000001
100000011000000000000001
111111111111111111111111