   WE                            assets/grey_stone.xpm
NO      assets/purple_stone.xpm



SO assets/wall_brick.xpm

F      17,    -38,     64

EA assets/wood.xpm



C 2184, 234, 235


1111111
110N011
11111
